11111111111111111111111111111111111111111111111111111111111111111111111111111111
1100C000011010000C000011110000C000011110000C000011110000C000011110000C0000111101
10000C0000C000011110000000111P1110000000001100011100001100C1000000E0000000000001
100C000011110000C000011110000C000011110000C000011110000C000011110000C00001111001
100C01011110000C000011110000C000011110000C000000000C0000111101000C00001111001001
10000C0000C000011110000110111P111000000000100011100001100C1000000E00000000000001
100C000011110000C000011110000C000011110000C000011110000C000011110000C00001111001
11111111111111111111111111111111111111111111111111111111111111111111111111111111
