11111111111111
10000010100001
10010101100011
10010C00001111
10011111100111
10000C00000001
100C0000111101
10111100011101
10010010000001
10000010100001
100C0101100011
10000C00001111
11011110000111
10000100000001
10000010100001
10010101100011
10010C00001111
10011111100111
10000C00000001
100C0000111101
10111100011101
10010010000001
10000010100001
100C0100111101
1000C100011101
10011110000001
10000010100001
100C1101100011
10001C00001011
1E001P000110C1
11111111111111